#......#
.#....#.
..#..#..
...##...
...##...
..#..#..
.#....#.
#......#