.......#
......#.
.....#..
....#...
...#....
..#.....
.#......
#.......