...##...
..####..
.######.
########
.######.
..####..
...##...
........