#.......
.#......
..#.....
...#....
....#...
.....#..
......#.
.......#